A#######
#      #
####   #
####  ##
B     ##
