###                 #########
#   ###################   # #
# ####                # # # #
# ##################### # # #
#                     # # # #
##################### # # # #
#   ##                # # # #
# # ###### ## ######### # # #
# #    #   ##           # # #
# # ## ################ # # #
### ##             #### # # #
### ############## ##B# # # #
###             ##    # # # #
###### ######## ######### # #
###### ####                 #
A      ######################